XXXXXXXXXXXXXXXXXXXX
X                  X
X     XXXXX        X
X     X   XXXX     X
X     X      X     X
X     XXXXXXXXXXXXXX
X            X     X
XXXXXXXXXXXXXXXXXXXX
